32
24
23 23 23 23 23 23 23 23 23 23 23 23 23 23 23 23 23 23 23 23 23 23 23 23 23 23 23 23 23 23 23 23
23 23 23 23 23 23 23 23 23 23 23 23 23 23 23 23 23 23 23 23 23 23 23 23 23 23 23 23 23 23 23 23
23 23 23 23 23 23 23 23 23 23 23 23 23 23 23 23 23 23 23 23 23 23 23 23 23 23 23 23 23 23 23 23
23 23 23 2 1 1 1 1 1 1 3 1 1 1 1 1 1 1 1 1 3 1 23 23 23 23 23 23 23 23 23 23
23 23 23 1 1 1 2 1 1 1 1 1 1 1 1 1 1 2 1 1 1 1 23 23 23 23 23 23 23 23 23 23
23 23 23 1 1 23 23 23 23 23 23 23 23 23 23 23 23 23 23 23 1 1 23 23 23 23 23 23 23 23 23 23
23 23 23 1 3 23 23 23 23 23 23 23 23 23 23 23 23 23 23 23 1 1 23 23 23 23 23 23 23 23 23 23
23 23 23 1 1 23 23 23 23 23 23 23 23 23 23 23 23 23 23 23 1 1 23 23 23 23 23 23 23 23 23 23
23 23 23 2 1 23 23 23 23 23 23 23 23 23 23 23 23 23 23 23 1 1 23 23 23 23 23 23 23 23 23 23
23 1 1 3 1 1 1 23 23 23 23 23 23 23 23 23 23 23 23 23 1 1 23 23 23 23 23 23 23 23 23 23
23 1 23 23 23 23 1 23 23 23 1 2 1 1 23 23 23 23 23 23 1 3 23 23 23 23 23 23 23 23 23 23
23 1 23 2 1 23 1 23 23 23 1 1 1 3 1 1 1 2 1 1 1 1 23 23 23 23 23 23 23 23 23 23
23 2 23 1 3 23 1 23 23 23 1 2 1 1 1 1 1 1 1 1 1 1 23 23 23 23 23 23 23 23 23 23
23 1 23 1 23 23 1 23 23 23 1 1 1 1 23 23 23 23 23 23 2 1 23 23 23 23 23 23 23 23 23 23
23 1 1 3 1 1 1 23 23 23 23 23 23 23 23 23 23 23 23 23 1 1 23 23 23 23 23 23 23 23 23 23
23 23 23 23 23 23 23 23 23 23 23 23 23 23 23 23 23 23 23 23 1 1 23 23 23 23 23 23 23 23 23 23
23 23 23 23 23 23 23 23 23 23 23 23 23 23 23 23 23 23 23 23 1 1 23 23 23 23 23 23 23 23 23 23
23 1 1 1 2 1 1 23 23 23 23 23 23 23 23 23 23 23 23 23 1 1 23 23 23 23 23 23 23 23 23 23
23 1 1 1 1 1 1 23 23 23 23 23 23 23 23 23 23 23 23 23 2 1 23 23 23 23 23 23 23 23 23 23
23 2 2 3 1 1 1 1 1 1 2 1 1 1 1 2 1 3 1 1 3 1 23 23 23 23 23 23 23 23 23 23
23 1 1 1 3 1 1 2 1 1 1 1 1 2 1 1 1 1 1 1 1 1 23 23 23 23 23 23 23 23 23 23
23 1 1 1 1 1 1 23 23 23 23 23 23 23 23 23 23 23 23 23 23 23 23 23 23 23 23 23 23 23 23 23
23 1 2 1 1 2 1 23 23 23 23 23 23 23 23 23 23 23 23 23 23 23 23 23 23 23 23 23 23 23 23 23
23 23 23 23 23 23 23 23 23 23 23 23 23 23 23 23 23 23 23 23 23 23 23 23 23 23 23 23 23 23 23 23
