32
32
20 20 20 20 20 22 20 20 22 22 22 22 22 22 22 22 20 20 20 20 20 20 20 20 20 20 20 20 20 20 20 20
20 20 01 01 01 01 01 01 01 01 01 01 01 01 01 22 20 20 20 20 20 20 20 20 20 20 20 20 20 20 20 20
20 20 01 20 20 20 20 22 22 22 22 22 01 01 20 22 20 20 20 20 20 20 20 20 20 20 20 20 20 20 20 20
20 20 01 20 20 01 20 22 22 22 22 22 01 20 20 22 20 20 20 20 20 20 20 20 20 20 20 01 01 20 20 20
20 20 01 20 20 01 20 22 22 22 22 22 22 22 20 22 20 20 20 20 20 20 20 20 20 20 20 01 01 20 20 20
20 20 01 01 01 01 20 20 22 22 22 22 22 22 20 22 20 20 20 20 20 20 20 20 20 20 20 21 21 20 20 20
20 20 01 20 20 20 20 20 22 22 22 22 22 22 20 22 20 20 20 20 20 20 20 20 20 20 20 21 21 20 20 20
20 20 01 20 20 20 20 20 22 22 22 22 22 22 22 22 20 20 20 20 20 20 20 20 20 20 20 01 01 20 20 20
20 20 01 20 20 20 20 20 20 20 22 22 22 20 20 20 22 22 22 20 20 20 22 20 20 20 20 01 01 20 20 20
20 20 01 20 20 20 20 20 20 01 01 01 01 01 01 01 01 01 01 01 01 01 20 20 20 20 20 01 01 20 20 20
20 20 01 20 20 20 20 20 20 01 01 03 01 01 01 01 01 03 01 01 01 01 22 20 20 20 20 01 01 20 20 20
20 20 01 20 20 20 20 20 22 01 01 01 01 01 01 01 01 01 01 01 02 01 22 20 20 20 20 01 01 20 20 20
20 20 01 20 20 20 20 20 22 01 02 01 01 02 01 01 01 01 03 01 01 01 22 20 20 20 20 01 01 20 20 20
20 01 01 01 20 20 20 20 22 01 01 03 01 01 01 01 01 01 01 01 01 01 22 20 20 20 20 01 01 20 20 20
20 01 01 01 20 20 20 20 20 01 01 01 01 01 02 01 01 01 01 01 01 01 20 20 20 20 20 01 01 20 20 20
20 01 01 01 20 20 20 20 20 01 01 01 03 01 01 01 01 02 01 01 01 01 20 20 20 20 20 01 01 20 20 20
20 01 01 01 20 20 20 20 20 01 01 01 01 01 01 01 01 01 01 01 01 01 20 20 20 20 20 01 01 20 20 20
20 01 01 01 20 20 20 20 20 01 01 01 01 01 01 03 01 01 01 01 01 01 22 20 20 20 20 01 01 20 20 20
20 01 01 01 20 20 20 20 21 01 01 01 01 01 01 01 01 01 02 03 01 01 22 20 20 20 20 01 01 20 20 20
20 01 01 01 20 20 20 20 20 01 03 01 01 03 01 01 03 01 01 01 01 01 20 20 20 20 20 01 01 20 20 20
20 01 01 01 01 01 20 20 20 01 01 01 01 01 01 01 01 01 01 01 01 01 22 20 20 20 20 01 01 20 20 20
20 01 01 01 01 01 20 20 22 01 01 02 01 01 01 02 01 01 01 01 01 01 20 20 20 20 20 01 01 20 20 20
20 01 01 01 20 20 20 20 20 01 01 01 01 01 01 01 01 01 01 01 01 01 20 20 20 20 20 01 01 20 20 20
20 01 01 01 20 20 20 20 20 20 22 01 01 22 22 20 20 20 22 20 22 20 20 20 20 20 20 01 01 20 20 20
20 01 01 01 20 20 20 22 01 01 22 01 01 20 20 20 20 20 20 20 20 20 20 20 20 20 20 01 01 20 20 20
20 01 01 01 01 01 01 20 20 20 22 01 01 22 20 20 20 20 20 20 20 20 20 20 20 20 20 01 01 20 20 20
20 01 02 01 01 03 01 20 20 20 22 01 01 22 20 20 20 20 20 20 20 20 20 20 20 20 20 21 21 20 20 20
20 01 01 01 01 01 01 01 01 01 01 01 01 01 01 01 01 01 01 01 01 01 01 01 01 01 01 01 01 20 20 20
20 01 03 02 01 01 01 01 01 01 01 01 01 01 01 01 01 01 01 01 01 01 01 01 01 01 01 01 01 20 20 20
20 01 01 01 01 01 01 01 01 01 01 01 01 01 01 01 20 20 20 20 20 20 20 20 20 20 20 20 20 20 20 20
20 01 01 01 01 02 01 20 20 20 20 20 20 20 20 20 20 20 20 20 20 20 20 20 20 20 20 20 20 20 20 20
20 20 20 20 20 20 20 20 20 20 20 20 20 20 20 20 20 20 20 20 20 20 20 20 20 20 20 20 20 20 20 20

