40
40
24 24 24 24 24 24 24 24 24 24 24 24 24 24 24 24 24 24 24 24 24 24 24 24 24 24 24 24 24 24 24 24 24 24 24 24 24 24 24 24 
24 24 24 24 7 6 24 24 24 24 24 24 24 24 24 24 24 24 24 24 24 24 24 24 24 24 24 24 24 24 24 24 24 24 24 24 24 24 24 24 
24 24 4 6 6 4 6 6 5 24 4 6 4 24 24 24 24 5 24 5 24 6 6 6 6 24 24 24 24 5 5 6 6 6 6 6 6 24 24 24 
24 5 6 6 4 6 6 7 6 6 6 6 6 6 24 24 24 24 24 24 6 6 7 4 6 6 5 24 24 5 6 7 6 4 6 4 6 6 24 24 
24 5 6 6 7 6 6 6 6 7 6 6 6 6 24 24 24 5 24 6 4 6 6 6 6 6 6 6 6 6 6 7 6 6 6 7 6 6 5 24 
24 5 4 6 6 6 4 6 4 4 6 6 6 6 24 24 24 5 5 6 6 6 6 6 6 4 6 6 6 6 6 6 7 6 4 6 6 24 24 24 
24 24 24 7 6 24 5 24 5 4 6 6 6 24 24 24 24 24 6 6 7 7 6 24 24 6 6 6 6 6 6 6 4 6 6 6 24 24 24 24 
24 24 24 24 24 24 24 24 24 24 6 6 6 24 24 24 24 24 6 6 24 24 24 24 24 24 24 6 6 6 24 24 24 24 24 24 24 24 24 24 
24 24 24 24 24 5 24 24 24 24 6 6 6 24 24 24 24 5 6 6 24 24 24 24 24 24 24 6 6 6 5 24 24 24 24 24 24 24 24 24 
24 24 24 24 24 24 24 24 24 6 7 6 6 6 6 24 24 5 6 7 24 24 24 24 24 24 6 6 6 6 5 24 24 24 24 24 24 24 24 24 
24 24 24 6 6 6 6 5 24 6 6 6 6 6 6 24 24 6 6 6 6 24 24 24 5 6 6 6 6 6 24 24 24 24 6 6 24 24 24 24 
24 24 6 6 7 6 6 24 24 6 6 6 6 6 4 24 24 6 4 6 6 6 24 24 24 6 6 6 6 24 24 24 24 6 7 6 6 24 24 24 
24 24 6 7 6 7 6 6 6 6 6 6 6 6 6 6 6 6 6 4 6 4 24 24 5 6 6 24 24 24 24 24 24 6 4 6 6 7 24 24 
24 24 6 6 7 6 6 24 5 6 6 6 6 6 7 6 7 6 7 6 6 6 24 24 24 7 6 24 24 6 6 7 6 6 4 6 6 6 24 24 
24 24 24 6 6 6 6 24 24 7 6 6 6 4 6 24 24 4 6 6 6 24 24 5 24 6 4 6 24 6 24 24 24 6 6 6 6 24 24 24 
24 5 24 5 6 24 24 5 24 24 24 24 24 24 4 24 24 24 24 24 24 24 24 5 24 24 24 6 24 4 24 24 24 24 24 6 4 24 24 24 
5 24 24 24 6 5 24 24 24 24 24 24 24 24 6 24 24 5 5 24 5 24 5 24 24 24 5 6 24 6 24 24 24 24 24 6 6 24 24 24 
24 24 24 24 64 24 24 24 24 24 24 6 6 4 6 24 24 6 6 6 6 6 6 24 24 4 7 6 24 6 24 24 24 24 24 7 6 24 24 24 
24 24 4 7 6 5 24 24 24 24 6 7 24 24 24 24 24 6 6 7 6 4 6 24 24 64 24 24 24 4 6 24 24 24 24 6 6 24 24 24 
24 24 6 24 24 24 24 24 24 6 6 24 24 24 24 24 24 6 4 6 6 7 6 24 24 7 6 4 24 24 6 24 24 24 24 24 6 24 24 24 
5 24 7 4 6 4 6 7 6 4 6 24 24 24 6 6 6 4 6 6 4 6 4 6 24 24 6 24 6 7 6 6 24 24 24 24 24 4 24 24 24 
24 24 24 5 24 5 24 24 24 6 6 6 24 24 24 24 24 6 7 4 6 6 7 24 24 4 5 5 5 5 5 24 24 24 24 24 6 24 24 24 
5 24 24 24 24 5 24 5 24 24 7 6 5 5 24 24 24 7 6 6 6 6 6 5 5 6 6 7 6 7 6 24 24 24 24 24 7 24 24 24 
24 5 5 5 24 5 24 24 24 24 24 6 24 24 24 24 24 24 24 24 24 24 5 5 5 5 24 24 24 24 6 24 24 24 24 24 6 24 24 24 
24 24 24 24 24 24 24 24 24 24 24 64 24 24 5 24 24 24 24 6 6 24 24 24 24 24 24 24 24 24 6 24 24 24 24 24 6 24 24 24 
24 24 24 24 24 24 24 24 24 24 24 6 6 24 24 24 24 24 6 6 6 24 24 24 24 24 24 7 6 6 6 24 24 24 24 24 6 7 6 24 
24 5 24 6 7 24 24 24 24 6 4 6 6 6 24 24 24 24 6 4 6 7 5 24 24 24 6 6 4 6 6 24 24 24 24 24 7 6 7 24 
24 24 6 6 6 4 6 24 6 6 7 6 6 6 6 24 24 24 6 7 6 4 5 5 24 4 6 7 6 6 6 7 6 7 24 24 24 7 24 24 
24 24 6 4 6 4 7 24 6 6 6 6 6 6 6 24 24 6 4 6 7 4 5 5 24 6 6 4 6 7 6 6 4 6 4 24 24 24 24 24 
24 24 24 6 6 6 6 24 24 24 6 6 6 7 6 6 6 7 6 6 6 6 24 24 24 7 6 6 4 6 5 24 24 7 6 6 6 6 6 24 
24 24 5 7 6 4 6 24 24 24 24 6 6 24 24 24 24 6 24 24 24 6 6 6 6 6 7 6 6 5 24 24 24 6 6 6 6 6 6 24 
24 24 24 4 6 24 24 24 24 24 24 24 24 24 24 24 24 24 24 24 24 5 24 24 5 24 24 24 24 24 24 24 24 24 24 6 6 6 6 24 
24 24 5 6 6 24 24 24 24 24 24 24 24 24 24 24 24 6 24 24 24 6 24 5 24 24 24 24 24 24 24 24 24 24 24 6 6 6 6 24 
24 24 24 6 6 24 24 24 24 24 24 24 24 24 6 6 6 7 24 24 24 6 6 6 6 7 6 24 24 24 24 24 24 24 6 6 6 6 6 24 
24 24 6 7 6 24 24 24 24 24 24 7 6 6 4 24 24 24 24 24 24 6 7 6 6 6 4 6 24 24 24 24 24 24 6 6 6 6 6 24 
24 24 4 6 6 24 24 24 24 24 24 4 24 24 24 24 24 24 24 24 6 4 6 7 6 7 6 7 6 24 24 24 24 24 6 6 6 6 6 24 
24 24 6 6 4 6 24 24 24 24 24 64 24 24 24 24 24 24 24 24 6 6 6 6 4 6 4 6 6 24 24 24 24 24 24 6 6 6 24 24 
24 24 24 6 7 6 6 6 6 6 4 6 24 24 24 24 24 24 24 24 24 7 6 6 7 6 4 6 24 24 24 24 24 24 24 6 6 6 24 24 
24 24 24 24 6 4 24 24 24 24 24 24 24 24 24 24 24 24 24 24 24 24 24 24 24 6 6 24 24 24 24 24 24 24 24 24 6 24 24 24 
24 24 24 24 24 24 24 24 24 24 24 24 24 24 24 24 24 24 24 24 24 24 24 24 24 24 24 24 24 24 24 24 24 24 24 24 24 24 24 24 
