40
40
20 20 20 20 20 20 20 20 20 20 20 20 20 20 20 20 20 20 20 20 20 20 20 20 20 20 20 20 20 20 20 20 20 20 20 20 20 20 20 20 
20 20 20 20 3 22 20 20 20 20 20 20 20 20 20 20 20 20 20 20 20 20 20 20 20 20 20 20 20 20 20 20 20 20 20 20 20 20 20 20 
20 20 2 22 22 2 22 22 20 20 2 22 2 20 20 20 20 20 20 20 20 22 22 22 22 20 20 20 20 20 20 22 22 22 22 22 22 20 20 20 
20 20 22 22 2 22 22 3 22 22 22 22 22 22 20 20 20 20 20 20 22 22 3 2 22 22 20 20 20 20 22 3 22 2 22 2 22 22 20 20 
20 20 22 22 3 22 22 22 22 3 22 22 22 22 20 20 20 20 20 22 2 22 22 22 22 22 22 22 22 22 22 3 22 22 22 3 22 22 20 20 
20 20 2 22 22 22 2 22 2 2 22 22 22 22 20 20 20 20 20 22 22 22 22 22 22 2 22 22 22 22 22 22 3 22 2 22 22 20 20 20 
20 20 20 3 22 20 20 20 20 2 22 22 22 20 20 20 20 20 22 22 3 3 22 20 20 22 22 22 22 22 22 22 2 22 22 22 20 20 20 20 
20 20 20 20 20 20 20 20 20 20 22 22 22 20 20 20 20 20 22 22 20 20 20 20 20 20 20 22 22 22 20 20 20 20 20 20 20 20 20 20 
20 20 20 20 20 20 20 20 20 20 22 22 22 20 20 20 20 20 22 22 20 20 20 20 20 20 20 22 22 22 20 20 20 20 20 20 20 20 20 20 
20 20 20 20 20 20 20 20 20 22 3 22 22 22 22 20 20 20 22 3 20 20 20 20 20 20 22 22 22 22 20 20 20 20 20 20 20 20 20 20 
20 20 20 22 22 22 22 20 20 22 22 22 22 22 22 20 20 22 22 22 22 20 20 20 20 22 22 22 22 22 20 20 20 20 22 22 20 20 20 20 
20 20 22 22 3 22 22 20 20 22 22 22 22 22 2 20 20 22 2 22 22 22 20 20 20 22 22 22 22 20 20 20 20 22 3 22 22 20 20 20 
20 20 22 3 22 3 22 22 22 22 22 22 22 22 22 22 22 22 22 2 22 2 20 20 20 22 22 20 20 20 20 20 20 22 2 22 22 3 20 20 
20 20 22 22 3 22 22 20 20 22 22 22 22 22 3 22 3 22 3 22 22 22 20 20 20 3 22 20 20 22 22 3 22 22 2 22 22 22 20 20 
20 20 20 22 22 22 22 20 20 3 22 22 22 2 22 20 20 2 22 22 22 20 20 20 20 22 2 22 20 22 20 20 20 22 22 22 22 20 20 20 
20 20 20 20 22 20 20 20 20 20 20 20 20 20 2 20 20 20 20 20 20 20 20 20 20 20 20 22 20 2 20 20 20 20 20 22 2 20 20 20 
20 20 20 20 22 20 20 20 20 20 20 20 20 20 22 20 20 20 20 20 20 20 20 20 20 20 20 22 20 22 20 20 20 20 20 22 22 20 20 20 
20 20 20 20 222 20 20 20 20 20 20 22 22 2 22 20 20 22 22 22 22 22 22 20 20 2 3 22 20 22 20 20 20 20 20 3 22 20 20 20 
20 20 2 3 22 20 20 20 20 20 22 3 20 20 20 20 20 22 22 3 22 2 22 20 20 222 20 20 20 2 22 20 20 20 20 22 22 20 20 20 
20 20 22 20 20 20 20 20 20 22 22 20 20 20 20 20 20 22 2 22 22 3 22 20 20 3 22 2 20 20 22 20 20 20 20 20 22 20 20 20 
20 20 3 2 22 2 22 3 22 2 22 20 20 20 22 22 222 22 22 2 22 2 22 20 20 22 20 22 3 22 22 20 20 20 20 20 2 20 20 20 
20 20 20 20 20 20 20 20 20 22 22 22 20 20 20 20 20 22 3 2 22 22 3 20 20 2 20 20 20 20 20 20 20 20 20 20 22 20 20 20 
20 20 20 20 20 20 20 20 20 20 3 22 20 20 20 20 20 3 22 22 22 22 22 20 20 22 22 3 22 3 22 20 20 20 20 20 3 20 20 20 
20 20 20 20 20 20 20 20 20 20 20 22 20 20 20 20 20 20 20 20 20 20 20 20 20 20 20 20 20 20 22 20 20 20 20 20 22 20 20 20 
20 20 20 20 20 20 20 20 20 20 20 222 20 20 20 20 20 20 20 22 22 20 20 20 20 20 20 20 20 20 22 20 20 20 20 20 22 20 20 20 
20 20 20 20 20 20 20 20 20 20 20 22 22 20 20 20 20 20 22 22 22 20 20 20 20 20 20 3 22 22 22 20 20 20 20 20 22 3 22 20 
20 20 20 22 3 20 20 20 20 22 2 22 22 22 20 20 20 20 22 2 22 3 20 20 20 20 22 22 2 22 22 20 20 20 20 20 3 22 3 20 
20 20 22 22 22 2 22 20 22 22 3 22 22 22 22 20 20 20 22 3 22 2 20 20 20 2 22 3 22 22 22 3 22 3 20 20 20 3 20 20 
20 20 22 2 22 2 3 20 22 22 22 22 22 22 22 20 20 22 2 22 3 2 20 20 20 22 22 2 22 3 22 22 2 22 2 20 20 20 20 20 
20 20 20 22 22 22 22 20 20 20 22 22 22 3 22 22 22 3 22 22 22 22 20 20 20 3 22 22 2 22 20 20 20 3 22 22 22 22 22 20 
20 20 20 3 22 2 22 20 20 20 20 22 22 20 20 20 20 22 20 20 20 22 22 22 22 22 3 22 22 20 20 20 20 22 22 22 22 22 22 20 
20 20 20 2 22 20 20 20 20 20 20 20 20 20 20 20 20 20 20 20 20 20 20 20 20 20 20 20 20 20 20 20 20 20 20 22 22 22 22 20 
20 20 20 22 22 20 20 20 20 20 20 20 20 20 20 20 20 22 20 20 20 22 20 20 20 20 20 20 20 20 20 20 20 20 20 22 22 22 22 20 
20 20 20 22 22 20 20 20 20 20 20 20 20 20 22 22 22 3 20 20 20 22 22 22 22 3 22 20 20 20 20 20 20 20 22 22 22 22 22 20 
20 20 22 3 22 20 20 20 20 20 20 3 22 22 2 20 20 20 20 20 20 22 3 22 22 22 2 22 20 20 20 20 20 20 22 22 22 22 22 20 
20 20 2 22 22 20 20 20 20 20 20 2 20 20 20 20 20 20 20 20 22 2 22 3 22 3 22 3 22 20 20 20 20 20 22 22 22 22 22 20 
20 20 22 22 2 22 20 20 20 20 20 222 20 20 20 20 20 20 20 20 22 22 22 22 2 22 2 22 22 20 20 20 20 20 20 22 22 22 20 20 
20 20 20 22 3 22 22 22 22 22 2 22 20 20 20 20 20 20 20 20 20 3 22 22 3 22 2 22 20 20 20 20 20 20 20 22 22 22 20 20 
20 20 20 20 22 2 20 20 20 20 20 20 20 20 20 20 20 20 20 20 20 20 20 20 20 22 22 20 20 20 20 20 20 20 20 20 22 20 20 20 
20 20 20 20 20 20 20 20 20 20 20 20 20 20 20 20 20 20 20 20 20 20 20 20 20 20 20 20 20 20 20 20 20 20 20 20 20 20 20 20 
